1|380|600|1|0
1|380|560|1|0
1|380|520|1|0
1|380|480|1|0
1|380|440|1|0
1|380|400|1|0
1|380|360|1|0
1|380|320|1|0
1|420|600|1|0
1|420|560|1|0
1|420|520|1|0
1|420|480|1|0
1|420|440|1|0
1|420|400|1|0
1|420|360|1|0
1|420|320|1|0
9|0|0|0|0
8|0|0|0|0