1|480|700|1|0
1|440|700|1|0
1|400|700|1|0
1|360|700|1|0
1|320|700|1|0
1|480|660|1|0
1|440|660|1|0
1|400|660|1|0
1|360|660|1|0
1|320|660|1|0
1|480|620|1|0
1|440|620|1|0
1|400|620|1|0
1|360|620|1|0
1|320|620|1|0
1|480|580|1|0
1|440|580|1|0
1|400|580|1|0
1|460|580|1|0
1|420|580|1|0
9|0|0|0|0
8|0|0|0|0