1|400|700|5|0
1|600|600|1|0
1|600|560|1|0
1|600|520|1|0
1|600|480|1|0
1|600|440|1|0
1|600|400|1|0
1|600|360|1|0
1|600|320|1|0
1|200|600|1|0
1|200|560|1|0
1|200|520|1|0
1|200|480|1|0
1|200|440|1|0
1|200|400|1|0
1|200|360|1|0
1|200|320|1|0
9|0|0|0|0
5|0|0|0|0
3|400|400|50|0
9|0|0|0|0
6|0|0|0|0
1|400|700|10|0
9|0|0|0|0
8|0|0|0|0